111111111111111111111111
1010E000001010C000000001
101000000000100011111111
10C000001111111001100011
1P1011011111110011000001
100001011111100000000001
1000000C0000000000000001
100100000010C00111111101
100100000010000000000101
100100C00010000000000101
100100000010000000000101
100111111110000111111101
1C0000000010000100000001
100000000010000100000001
100000000010000111111101
100000000000000000000001
111111111111111111111111