11111111111111111111111111111
1P000000000000000000000000001
1000000C000000000000000000001
10000000000000000000000000001
10000000000000000000000000001
10E00000000000000000000000001
10000000000000000000000000001
10000000000000000000000000001
10000000000000000000000000001
10000000000000000000000000001
10000000000000000000000000001
10000000000000000000000000001
10000000000000000000000000001
10000000000000000000000000001
10000000000000000000000000001
11111111111111111111111111111