11111111111111111111111111111
1010E00000C00010C0000000C0001
101C0000000000100000011111111
101111000000001000000100C0001
1P000C00000000100000010000001
11111000000011111000011100001
1C00100C000000000000000000C01
10001000000000000000000000001
1000000000000000000C000000001
10000100000010C00111111100001
10000100C00010000000000100001
10000111111110000111111100001
100C0000000010000100000000001
10000000000010000111111100C01
10000000000000000000000000001
11111111111111111111111111111